0	0
אוסף	אוסף
אוסף_נושא	אוסף
אוסף_סגנון	אוסף
אוסף_תוספת	אוסף
אין	מאמר דמיוני
אתר	אתר
בסיס	מאמר
דיון	מאמר
דיון1	מאמר
דיון2	מאמר
דקדוק	מאמר
דרך	דרך
הבדל	הבדלים
הבדל_דמות	הבדלים
הבדלים1	הבדלים
הבדלים2	הבדלים
הגדרה	הגדרה
הגדרה_שביל	הגדרה
הפוך	מאמר דמיוני
הפניהמהירה	הפניה
השלמה1	הבדלים
השלמה2	הבדלים
התאמה1	הבדלים
התאמה2	הבדלים
זמר	שיר
טבלה	קובץ
טעם	מאמר
כלל	כלל
כלל_אזור	כלל
כלל_דמות	כלל
כלל_ספר	כלל
לא_גמור	מאמר לא גמור
לא_פורסם	מאמר שלא פורסם
מאגר	קובץ
מאמר	מאמר
מארז	קובץ
מבוא	מבוא
מבנה1	מבנה
מבנה2	מבנה
מחאה	דרך
מניעים1	מאמר
מניעים2	כלל
מסקנה	מאמר
מפתח	קובץ
מצגת	מצגת
מצוות	מצוות
מצוות_אדם	מצוות
מצוות_ארוע	מצוות
מצוות_זמן	מצוות
מצוות_חובת	מצוות
מצוות_מקום	מצוות
מצוות_עצם	מצוות
מצוות_ערך	מצוות
מצוות_רגע	מצוות
מצוות_רצון	מצוות
משחק	משחק
משל	מאמר
סימן	מאמר דמיוני
סיפור	סיפור
ספר	ספר
סרט	סרט
פירוש	מאמר
פסוק	פסוק
פסוק_דמיונ	מאמר דמיוני
פרטים1	מאמר
פרטים2	מאמר
פתיחה	פתיחה
ציור	ציור
צילום	ציור
קובץ	קובץ
רבשורש	אוסף
רקע	מאמר
שאלות	מאמר לא גמור
שות	אתר
שיר	שיר
שלומית	מאמר
תוכן1	מאמר
תוכן2	מאמר
תוכן_מפורט	תרגומים
תכלית	מאמר
קהילה	אתר
הלכות	הלכות
הפניה	הפניה
