
אבן	עצם
אדם קרוב	תואר
אוכל	עצם
אוסף	מאמר
אוסף_נושא	מאמר
אוסף_סגנון	מאמר
אוסף_תוספת	מאמר
אופי	מופשט
אות	אות
אין	מאמר דמיוני
אתר	מאמר
בגד	כלי
בגד מלחמה	כלי
בושם	עצם
בסיס	מאמר
בעל תכונה	תואר
בעל תפקיד	תואר
גוף	עצם
דיון1	מאמר
דיון2	מאמר
דקדוק	מאמר
הבדל	הבדל
הבדל_דמות	מאמר
הבדלים1	הבדל
הבדלים2	הבדל
הגדרה	הגדרה
הגדרה_שביל	הגדרה
הפוך	מאמר דמיוני
הפעיל	פועל
הפעל	פועל
השלמה1	מאמר
השלמה2	מאמר
התאמה1	מאמר
התאמה2	מאמר
התפעל	פועל
זמן	מופשט
חומר	עצם
חומר בנין	עצם
חיה	חיה
חית מים	חיה
חרק	חיה
טבלה	מאמר
טעם	מאמר
כלי	כלי
כלי אש	כלי
כלי חיתוך	כלי
כלי כתיבה	כלי
כלי נגינה	כלי
כלי נשק	כלי
כלי קיבול	כלי
כלל	מאמר
כלל_אזור	מאמר
כלל_דמות	מאמר
כלל_ספר	מאמר
לא_גמור	מאמר לא גמור
לא_פורסם	מאמר שלא פורסם
מאגר	מאמר
מאמר	מאמר
מארז	מאמר
מבנה	כלי
מבנה1	מאמר
מבנה2	מאמר
מופשט	מופשט
מחלה	מופשט
מטבע	כלי
מידה	כלי
מילה	מילה
מילת גוף	מילה
מילת חיבור	מילה
מילת יחס	מילה
מילת קריאה	מילה
מילת שאלה	מילה
מילת שלילה	מילה
מלאך	חיה
מניעים1	מאמר
מניעים2	מאמר
מספר	מופשט
מסקנה	מאמר
מפתח	מאמר
מצגת	מאמר
מצוות	מאמר
מקום	תואר
מקום מתואר	תואר
מקום פרטי	תואר
מראה	מופשט
משחק	מאמר דמיוני
משל	מאמר
מתכת	עצם
נפעל	פועל
סימן	מאמר דמיוני
סיפור	מאמר דמיוני
ספר	מאמר
עוף	חיה
עלשורש_אות	עלשורש_אות
עלשורש_סדר	עלשורש_סדר
עצם בארץ	עצם
עצם ברקיע	עצם
עצם בשמים	עצם
עשב	חיה
פיעל	פועל
פיעל הפוך	פועל
פירוש	מאמר
פסוק	תוכן1
פסוק_דמיונ	מאמר דמיוני
פעל	פועל
פ?על	פועל
פרטים1	מאמר
פרטים2	מאמר
פרי	עצם
צבע	עצם
ציור	ציור
צמח	חיה
קבוצת אדם	תואר
קובץ	מאמר
קול	מופשט
קרבן	עצם
רבשורש	רבשורש
רגש	מופשט
רקע	מאמר
שורש1	שורש1
שורש2	שורש2
שיר	מאמר דמיוני
שם מתואר	תואר
שם פרטי	תואר
שם קיבוצי	עצם
שם1	שם1
תאריך	מופשט
תואר	תואר
תואר פועל	תואר
תוכן_מפורט	מאמר
תוכן1	תוכן1
תוכן2	מאמר
תכלית	מאמר
תכשיט	כלי
תתשורש	תתשורש
